NO textures/bricksx64.xpm
SO textures/bricksx64.xpm
WE textures/bricksx64.xpm
EA textures/bricksx64.xpm

F 100,100,100
C 10,10,10

11111111111111111111111        11111111111
10000000000000000000001        10000000001
 10000000000000000000001      10000000001
  10000000000000000000001    10000000001
   10000000E00000000000001  10000000001
    1000000000000000000000110000000001
     10111111000000000000010000000001
     1010110100000000000000000000001
     101111110000111010000000000001
     10010010000000101000000000001
     1001001000001111100000000001
     100100100000101000000000001
     10011110000010111000000001
     1001001000000000000000001
     100011000000000000000001
     10000000000000000000001
     11111111111111111111111