NO textures/TECH.xpm
SO textures/TECH.xpm
WE textures/TECH.xpm
EA textures/TECH.xpm

CD textures/DOOR.xpm
OD textures/OPEN.xpm

CE textures/LIGHT.xpm
FL textures/FLOOR.xpm 

F 86,112,63
C 35,54,76

111111111111111111111
101000001000000000001
101010101011111110001
100010100010000010001
1111101011111010111O1
100000101000101000001
101111101011101111111
101000001010100000101
101011111010111110101
101010001010100010101
101110101010101010101
100000101010001010001
111111101011111011101
100000101000100010001
101110101110101110111
101000100000100010101
1C1011111111111010101
100EO0000O00000010001
101010111011111111101
101000001000000000001
111111111111111111111
