NO textures/TECH.xpm
SO textures/TECH.xpm
WE textures/TECH.xpm
EA textures/TECH.xpm

CD textures/DOOR.xpm
OD textures/OPEN.xpm

CE textures/LIGHT.xpm
FL textures/FLOOR.xpm

F 86,112,63
C 35,54,76


11111111
1010O001
100OEO01
10100001
11111111