NO textures/wall.xpm
SO textures/wall.xpm
WE textures/wall.xpm
EA textures/wall.xpm

F 220,100,0
C 225,30,0

11111111111111111111111        11111111111
10000000000000000000001        10000000001
 10000000000000000000001      10000000001
  10000000000000000000001    10000000001
   10000000E00000000000001  10000000001
    1000000000000000000000110000000001
     10000000000000000000010000000001
     1000000000000000000000000000001
     100000000011111111100000000001
     10000000000111111100000000001
     1000000000001111100000000001
     100000000000011100000000001
     10000000000000100000000001
     1000000000000000000000001
     100000000000000000000001
     10000000000000000000001
     11111111111111111111111